{
	"player" : [ 6, 23 ],
	"width"  : 40,
	"height" : 24,
	"data" : [
		[
			[0,0,0,0,0,0,0,0,0,0,0,0,0,0,0,0,0,0,0,0,0,0,0,0,0,0,0,0,0,0,0,0,0,0,0,0,0,0,0,0],
			[971,972,971,972,971,972,971,972,971,972,971,972,971,972,971,972,971,972,971,972,971,972,971,972,971,972,971,972,971,972,971,972,971,972,729,730,971,972,971,972],
			[975,976,975,976,975,976,975,976,975,976,975,976,975,976,975,976,975,976,975,976,975,976,975,976,975,976,975,976,975,976,975,976,975,976,733,734,975,976,975,976],
			[971,972,971,972,971,972,971,972,971,972,971,972,971,972,971,972,971,972,971,972,971,972,971,972,971,972,971,972,971,972,971,972,971,972,971,972,971,972,971,972],
			[975,976,975,976,975,976,975,976,975,976,975,976,975,976,975,976,975,976,975,976,975,976,975,976,975,976,975,976,975,976,975,976,975,976,975,976,975,976,975,976],
			[971,972,971,972,971,972,971,972,971,972,971,972,971,972,971,972,971,972,971,972,971,972,971,972,971,972,971,972,971,972,971,972,971,972,971,972,971,972,971,972],
			[975,976,975,976,975,976,975,976,975,976,975,976,975,976,975,976,975,976,975,976,975,976,975,976,975,976,975,976,975,976,975,976,975,976,975,976,975,976,975,976],
			[971,972,971,972,971,972,971,972,729,730,971,972,971,972,971,972,971,972,971,972,971,972,971,972,971,972,971,972,971,972,971,972,971,972,971,972,971,972,971,972],
			[975,976,975,976,975,976,975,976,733,734,975,976,975,976,975,976,975,976,975,976,975,976,975,976,975,976,975,976,975,976,975,976,975,976,975,976,975,976,975,972],
			[971,972,477,478,971,972,971,972,971,972,971,972,971,972,971,972,971,972,971,972,971,972,971,972,971,972,971,972,971,972,971,972,971,972,971,972,460,972,971,972],
			[975,976,975,976,975,976,975,976,975,976,975,976,975,976,975,976,975,976,975,976,975,976,975,976,975,976,975,976,975,976,975,976,975,976,975,976,975,976,975,972],
			[971,972,971,972,971,972,971,972,971,972,971,972,971,972,971,972,729,730,971,972,971,972,971,972,971,972,971,972,971,972,971,972,971,972,971,972,971,972,971,972],
			[975,976,975,976,975,976,975,976,975,976,975,976,975,976,975,976,733,734,975,976,975,976,975,976,975,976,975,976,975,976,975,976,975,976,975,976,975,976,975,972],
			[971,972,971,972,971,972,971,972,971,972,971,972,971,972,971,972,971,972,971,972,971,972,971,972,971,972,971,972,971,972,971,972,971,972,971,972,971,972,971,972],
			[975,976,975,976,975,976,975,976,975,976,975,976,975,976,975,976,975,976,975,976,975,976,975,976,975,976,975,976,975,976,975,976,975,976,975,976,975,976,975,976],
			[971,972,971,972,971,972,971,972,971,972,971,972,971,972,971,972,971,972,971,972,971,972,971,972,971,972,971,972,971,972,971,972,971,972,971,972,971,972,971,972],
			[975,976,975,976,975,976,975,976,975,976,975,976,975,976,975,976,975,976,975,976,975,976,975,976,975,976,975,976,975,976,975,976,975,976,975,976,975,976,975,976],
			[971,972,971,972,971,972,971,972,971,972,971,972,971,972,971,972,971,972,971,972,971,972,971,972,971,972,971,972,971,972,971,972,971,972,971,972,971,972,971,972],
			[975,976,975,976,975,976,975,976,975,976,975,976,975,976,975,976,975,976,975,976,975,976,975,976,975,976,975,976,975,976,975,976,975,976,975,976,460,976,975,976],
			[971,972,971,972,971,972,971,972,971,972,971,972,971,972,971,972,971,972,971,972,971,972,971,972,971,972,971,972,971,972,971,972,971,972,971,972,971,972,971,972],
			[975,976,975,976,975,976,975,976,975,976,975,976,975,976,975,976,975,976,975,976,975,976,975,976,975,976,975,976,975,976,975,976,975,976,975,976,975,976,975,976],
			[971,972,971,972,971,972,971,972,971,972,971,972,971,972,971,972,971,972,971,972,971,972,971,972,971,972,971,972,971,972,971,972,971,972,971,972,971,972,971,972],
			[975,976,975,976,975,976,975,976,975,976,975,976,975,976,975,976,975,976,975,976,975,976,975,976,975,976,975,976,975,976,975,976,975,976,975,976,975,976,975,976],
			[0,0,0,0,0,0,0,0,0,0,0,0,0,0,0,0,0,0,0,0,0,0,0,0,0,0,0,0,0,0,0,0,0,0,0,0,0,0,0,0]
		],
		[
			[0,0,0,0,0,0,0,0,0,0,0,0,0,0,0,0,0,0,0,0,0,0,0,0,0,0,0,0,0,0,0,0,0,0,0,0,0,0,0,0],
			[0,0,0,0,0,0,0,0,0,0,0,0,0,0,0,0,0,0,0,0,0,0,0,0,0,0,0,0,0,0,0,0,0,0,0,0,0,0,0,0],
			[0,0,0,0,0,0,0,0,411,410,410,410,410,413,0,0,0,0,0,0,414,410,410,410,410,412,0,0,0,0,0,0,0,0,0,0,0,0,0,0],
			[0,0,0,0,0,0,0,0,0,0,0,0,0,411,410,410,410,410,410,410,412,0,0,0,0,0,0,0,0,0,0,0,0,0,0,0,0,0,0,0],
			[0,0,0,0,0,0,0,0,0,0,0,0,0,0,0,0,0,0,0,0,0,0,0,0,0,0,0,0,0,0,0,0,0,0,0,0,0,0,0,0],
			[0,0,0,0,0,0,0,0,0,0,0,0,0,0,0,0,0,0,0,0,0,0,0,0,0,0,0,0,0,0,0,0,0,0,0,0,0,0,989,0],
			[0,0,0,0,0,0,0,0,0,0,0,0,0,0,0,0,0,0,0,0,0,0,585,593,0,0,0,0,0,0,0,0,0,0,0,0,0,0,0,0],
			[0,0,0,0,0,0,0,0,0,0,0,0,0,0,0,0,0,0,0,0,0,0,589,597,0,0,437,0,0,0,0,0,0,0,0,0,0,0,989,0],
			[0,0,0,0,0,0,0,0,0,0,0,0,0,0,0,0,0,0,0,0,0,0,0,0,0,0,0,0,0,0,0,0,0,0,0,0,0,0,0,0],
			[0,0,0,0,0,0,0,0,0,0,0,0,0,0,0,0,0,0,0,0,0,0,0,0,0,0,0,0,0,0,0,0,0,0,0,0,0,0,0,0],
			[0,0,0,0,0,0,0,0,0,0,0,0,0,0,0,409,0,0,0,0,0,0,0,0,0,0,0,0,0,0,0,0,0,0,0,0,0,0,0,0],
			[0,0,0,0,0,0,0,0,0,0,0,0,0,0,0,409,0,0,0,0,0,0,0,0,0,0,0,0,0,0,0,0,0,0,0,0,0,0,0,0],
			[0,0,145,146,0,0,0,0,0,0,0,0,0,0,0,409,0,0,0,0,0,0,0,0,603,0,0,0,0,0,0,0,0,0,0,0,0,0,0,0],
			[0,0,0,0,0,0,0,0,0,0,0,0,0,0,0,409,0,0,0,0,0,0,0,584,576,0,0,0,0,0,0,0,0,0,0,0,0,0,0,0],
			[0,0,0,0,0,0,0,0,0,0,0,0,0,0,0,0,0,0,0,0,0,0,576,576,608,0,0,0,0,414,410,0,0,0,0,410,410,413,0,0],
			[0,0,0,0,0,0,0,0,0,0,0,0,0,0,0,0,0,0,0,0,0,0,0,0,0,0,0,0,0,409,0,0,0,0,0,0,0,411,413,0],
			[0,0,0,0,0,0,0,0,0,0,0,0,0,0,0,409,0,0,0,0,0,0,0,0,0,0,0,0,0,409,0,0,0,0,0,0,0,0,409,0],
			[0,0,0,0,0,0,0,0,0,0,0,0,0,0,0,411,413,895,414,410,410,410,410,410,410,410,410,410,410,412,0,0,0,0,0,0,0,0,409,0],
			[0,0,0,0,0,0,0,0,0,0,0,0,0,0,0,0,411,899,412,0,0,0,0,0,0,0,0,0,0,0,0,0,0,0,0,0,0,0,409,0],
			[0,0,0,0,0,0,0,0,0,0,0,0,0,0,0,0,0,0,0,0,0,0,0,0,0,0,0,0,0,0,0,0,0,0,0,0,0,0,409,0],
			[0,0,0,0,0,0,0,0,0,0,0,0,0,0,0,0,0,0,0,0,0,0,0,0,0,0,0,0,0,0,0,0,0,0,0,0,620,0,409,0],
			[0,0,0,0,0,0,0,0,0,0,0,0,0,0,0,0,0,0,0,0,0,0,0,0,0,0,0,0,0,0,0,414,410,410,410,410,410,410,412,0],
			[0,0,0,0,0,0,0,0,0,0,0,0,0,0,0,0,0,0,0,0,0,0,0,0,0,0,0,0,0,0,0,409,0,0,0,0,0,0,673,0],
			[0,0,0,0,0,0,0,0,0,0,0,0,0,0,0,0,0,0,0,0,0,0,0,0,0,0,0,0,0,0,0,0,0,0,0,0,0,0,0,0]
		],
		[
			[1122,1118,1118,1118,1118,1118,1118,1118,1122,1122,1122,1122,1122,1118,1118,1118,1118,1118,1118,1118,1118,1122,1122,1122,1122,1122,1118,1118,1118,1118,1118,1118,1118,1118,1118,1118,1118,1118,1118,1122],
			[1123,0,0,0,0,0,0,0,1117,1118,1118,1118,1119,0,0,0,0,0,0,0,0,1117,1118,1118,1118,1119,0,0,0,0,0,0,0,0,0,0,0,0,0,1121],
			[1123,0,0,0,0,0,0,0,0,0,0,0,0,0,0,0,0,0,0,0,0,0,0,0,0,0,0,0,0,0,0,0,0,0,0,0,0,0,0,1121],
			[1123,0,0,0,0,0,0,0,0,0,0,0,0,0,0,0,0,0,0,0,0,0,0,0,0,0,0,0,0,1113,1114,1114,1114,1114,1114,1114,1115,0,0,1121],
			[1123,0,0,0,0,0,1113,1114,1114,1114,1114,1114,1114,1114,1114,1114,1114,1114,1114,1114,1114,1114,1114,1114,1114,1114,1114,1114,1114,1122,1122,1122,1122,1122,1122,1122,1119,0,0,1121],
			[1123,0,0,0,0,0,1121,1118,1118,1118,1118,1118,1118,1118,1118,1118,1118,1118,1118,1118,1118,1118,1118,1118,1122,1122,1118,1118,1122,1122,1118,1118,1122,1122,1118,1119,0,0,0,1121],
			[1123,0,0,0,0,1113,1119,0,0,0,0,0,0,0,0,0,0,0,0,0,0,0,0,0,1121,1123,0,0,1117,1119,0,0,1121,1123,0,0,0,0,0,1121],
			[1122,1114,1114,1114,1114,1119,0,0,0,0,0,0,0,0,0,0,0,0,0,0,0,0,0,0,1121,1123,0,0,0,0,0,1113,1122,1122,1115,0,0,0,0,1121],
			[1122,1118,1118,1118,1119,0,0,0,0,0,0,0,0,1113,1114,1114,1114,1115,0,0,0,1113,1114,1114,1122,1122,1115,0,0,0,1113,1122,1122,1122,1119,0,0,0,0,1121],
			[1123,0,0,0,0,0,0,0,0,0,0,1113,1114,1118,1118,1118,1118,1118,1114,1114,1114,1122,1118,1118,1118,1122,1123,0,0,0,1117,1122,1122,1123,0,0,0,0,0,1121],
			[1123,0,0,0,0,0,1113,1114,1114,1114,1114,1118,1119,0,0,0,0,0,1117,1118,1118,1119,0,0,0,1121,1122,1115,0,0,0,1117,1122,1122,1115,0,0,0,0,1121],
			[1123,0,0,0,0,0,1117,1118,1118,1118,1119,0,0,0,0,0,0,0,0,0,0,0,0,0,0,1121,1122,1123,0,0,0,0,1121,1122,1119,0,0,0,0,1121],
			[1123,0,0,0,0,0,0,0,0,0,0,0,0,0,0,0,0,0,0,0,0,0,0,0,0,1121,1122,1119,0,0,0,0,1121,1123,0,0,0,0,0,1121],
			[1122,1114,1114,1115,0,0,0,0,0,0,0,0,0,0,0,0,0,0,0,0,0,0,0,0,0,1121,1123,0,0,0,0,0,1121,1122,1115,0,0,0,0,1121],
			[1122,1118,1118,1119,0,0,0,0,0,0,0,0,1113,1114,1114,1114,1114,1114,1115,0,0,0,0,0,0,1121,1123,0,0,0,0,1113,1122,1122,1119,0,0,0,0,1121],
			[1123,0,0,0,0,0,1113,1114,1114,1114,1114,1114,1122,1118,1118,1118,1118,1118,1122,1114,1114,1114,1114,1114,1114,1122,1119,0,0,0,0,1117,1122,1123,0,0,0,0,0,1121],
			[1123,0,0,0,0,0,1117,1118,1118,1118,1118,1118,1119,0,0,0,0,0,1117,1118,1118,1118,1118,1118,1118,1119,0,0,0,0,0,0,1121,1122,1115,0,0,0,0,1121],
			[1122,1114,1114,1115,0,0,0,0,0,0,0,0,0,0,0,0,0,0,0,0,0,0,0,0,0,0,0,0,0,0,0,0,1121,1122,1123,0,0,0,0,1121],
			[1122,1118,1118,1119,0,0,0,0,0,1113,1114,1114,1114,1114,1114,1115,0,0,0,0,0,0,0,0,0,0,0,0,0,0,0,0,1121,1122,1119,0,0,0,0,1121],
			[1123,0,0,0,0,0,1113,1114,1114,1122,1118,1118,1118,1118,1118,1122,1114,1114,1114,1114,1114,1114,1114,1114,1114,1114,1114,1114,1114,1114,1114,1114,1122,1119,0,0,0,0,0,1121],
			[1123,0,0,0,0,0,1117,1118,1118,1119,0,0,0,0,0,1117,1118,1118,1118,1118,1118,1118,1118,1118,1118,1118,1118,1118,1118,1118,1118,1118,1119,0,0,0,0,0,0,1121],
			[1122,1114,1114,1115,0,0,0,0,0,0,0,0,0,0,0,0,0,0,0,0,0,0,0,0,0,0,0,0,0,0,0,0,0,0,0,0,0,0,0,1121],
			[1122,1122,1122,1123,0,0,0,0,0,0,0,0,0,0,0,0,0,0,0,0,0,0,0,0,0,0,0,0,0,0,0,0,0,0,0,1113,1114,1115,0,1121],
			[1122,1122,1122,1122,1114,1114,1114,1114,1114,1114,1114,1114,1114,1114,1114,1114,1114,1114,1114,1114,1114,1114,1114,1114,1114,1114,1114,1114,1114,1114,1114,1114,1114,1114,1114,1114,1114,1114,1114,1122]
		],
		[
			[0,0,0,0,0,0,0,0,0,0,0,0,0,0,0,0,0,0,0,0,0,0,0,0,0,0,0,0,0,0,0,0,0,0,0,0,0,0,0,0],
			[0,0,0,0,0,0,0,0,0,0,0,0,0,0,0,0,0,0,0,0,0,0,0,0,0,0,582,0,0,0,0,0,0,0,0,0,0,0,0,0],
			[0,0,129,0,0,0,129,0,0,0,0,0,0,0,0,0,0,0,0,0,0,0,0,0,0,0,0,0,0,0,0,509,0,0,0,0,0,0,0,0],
			[0,0,0,0,0,0,0,0,0,0,0,0,0,0,0,178,0,0,0,0,0,0,0,0,0,0,0,0,0,0,0,0,0,0,0,0,0,0,0,0],
			[0,0,0,0,0,0,0,0,0,0,0,0,0,0,0,0,0,0,0,0,0,0,0,0,0,0,0,0,0,0,0,0,0,0,0,0,0,0,0,0],
			[0,0,0,0,0,0,0,0,0,0,0,0,0,0,0,0,0,0,0,0,0,0,0,0,0,0,0,0,0,0,0,0,0,0,0,0,0,0,0,0],
			[0,0,0,0,129,0,0,0,0,0,0,0,0,442,0,0,0,443,0,0,0,0,0,0,0,0,0,0,0,0,0,0,0,0,0,0,0,0,0,0],
			[0,0,0,0,0,0,0,0,0,0,0,0,0,446,0,0,0,447,0,0,0,0,0,0,0,0,0,0,0,0,0,0,0,0,0,0,0,0,0,0],
			[0,0,0,0,0,0,0,0,0,0,0,0,0,0,0,0,0,0,0,0,0,0,0,0,0,0,0,0,0,0,0,0,0,0,0,0,0,0,0,0],
			[0,0,0,0,0,0,0,0,0,0,0,0,0,0,0,0,0,0,0,0,0,0,0,0,0,0,0,0,0,0,0,0,0,0,0,0,0,0,0,0],
			[0,0,0,0,0,0,0,0,0,0,0,0,0,0,0,0,0,0,0,0,0,0,0,0,0,0,0,0,0,0,0,0,0,0,0,0,0,0,0,0],
			[0,0,0,0,0,0,0,0,0,0,0,0,0,0,0,0,0,0,0,0,0,0,929,0,0,0,0,0,0,0,0,0,0,0,0,0,0,0,0,0],
			[0,0,0,0,0,0,0,0,0,0,0,0,0,0,1029,0,0,0,0,0,0,0,0,0,0,0,0,0,0,0,0,0,0,0,0,0,0,0,0,0],
			[0,0,0,0,0,0,0,0,0,0,0,0,0,0,1033,0,0,0,0,0,0,0,0,0,0,0,0,0,0,0,0,0,0,0,0,0,0,0,0,0],
			[0,0,0,0,0,0,0,0,0,0,0,0,0,0,0,0,0,0,0,0,0,0,0,0,0,0,0,0,0,0,0,0,0,0,0,0,0,0,0,0],
			[0,0,0,0,0,0,0,0,0,0,0,0,0,0,0,0,0,0,0,0,0,0,0,0,0,0,0,0,0,0,0,0,0,0,0,0,0,0,0,0],
			[0,0,0,0,0,0,0,0,0,0,0,0,0,0,0,0,0,0,0,0,0,0,0,0,0,0,0,0,0,0,0,0,0,0,0,0,0,0,0,0],
			[0,0,0,0,0,0,0,0,0,0,0,0,0,0,0,0,0,0,0,0,0,0,0,0,0,0,0,0,0,0,0,0,0,0,0,0,0,0,0,0],
			[0,0,0,0,0,0,0,0,0,0,0,0,0,0,0,0,0,0,0,0,0,0,0,0,0,0,0,0,0,242,0,0,0,0,0,0,0,0,0,0],
			[0,0,0,0,0,0,0,0,0,0,0,0,0,0,0,0,0,0,0,0,0,0,0,0,0,0,0,0,0,0,0,0,0,0,0,0,0,0,0,0],
			[0,0,0,0,0,0,0,0,0,0,0,0,0,0,0,0,0,0,0,0,0,0,0,0,0,0,0,0,0,0,0,0,0,0,0,0,0,0,0,0],
			[0,0,0,0,0,0,0,0,0,0,0,0,0,0,0,0,0,0,0,0,0,0,0,0,0,0,0,0,0,0,0,0,0,0,0,0,0,0,0,0],
			[0,0,0,0,0,0,0,0,0,0,0,0,242,0,0,0,0,0,0,0,0,509,0,0,0,0,0,0,0,0,0,0,0,0,0,0,0,0,0,0],
			[0,0,0,0,0,0,0,0,0,0,0,0,0,0,0,0,0,0,0,0,0,0,0,0,0,0,0,0,0,0,0,0,0,0,0,0,0,0,0,0]
		],
		[
			[0,0,0,0,0,0,0,0,0,0,0,0,0,0,0,0,0,0,0,0,0,0,0,0,0,0,0,0,0,0,0,0,0,0,0,0,0,0,0,0],
			[0,0,0,626,627,0,0,0,0,0,0,0,0,0,625,0,309,0,628,0,0,0,0,0,0,0,0,0,0,0,625,0,628,627,0,0,0,0,0,0],
			[0,628,0,0,0,0,0,0,0,0,0,0,0,0,0,0,0,0,0,0,0,0,0,0,0,0,0,0,0,0,0,0,0,0,0,0,0,0,0,0],
			[0,0,0,0,0,0,0,0,0,0,0,0,0,0,0,0,0,0,0,0,0,0,0,0,0,0,0,0,0,0,0,0,0,0,0,0,0,0,0,0],
			[0,627,0,0,0,0,0,0,0,0,0,0,0,0,0,0,0,0,0,0,0,0,0,0,0,0,0,0,0,0,0,0,0,0,0,0,0,0,0,0],
			[0,0,0,0,0,0,0,0,0,0,0,0,0,0,0,0,0,0,0,0,0,0,0,0,0,0,0,0,0,0,0,0,0,0,0,0,0,0,0,0],
			[0,625,0,0,0,0,0,0,0,0,0,0,0,0,0,0,0,0,0,0,0,0,0,0,0,0,0,0,0,0,0,9,0,0,4,0,0,0,0,0],
			[0,0,0,0,0,0,0,0,0,0,0,0,0,0,0,0,0,0,0,0,0,0,0,0,0,0,0,0,0,0,11,0,0,0,0,0,0,0,0,0],
			[0,0,0,0,0,0,0,0,0,0,0,0,0,0,0,0,0,0,0,0,0,0,0,0,0,0,0,625,0,0,0,0,0,0,0,0,0,0,0,0],
			[0,625,0,0,0,0,0,0,0,0,0,0,0,0,0,0,0,0,0,0,0,0,0,0,0,0,0,627,0,0,0,0,0,0,4,0,0,0,0,0],
			[0,309,0,0,0,0,0,0,0,0,0,0,0,626,0,0,0,628,0,0,0,0,0,0,0,0,0,0,0,0,0,0,0,0,0,0,0,0,0,0],
			[0,0,0,0,0,0,0,0,0,0,0,0,0,0,0,0,0,0,0,0,0,0,0,0,0,0,0,0,0,0,0,0,0,0,0,0,0,0,0,0],
			[0,0,0,0,0,0,0,0,0,0,0,0,0,0,0,0,0,0,0,0,0,0,0,0,0,0,0,0,0,0,0,0,0,0,4,0,0,0,0,0],
			[0,0,0,0,0,0,0,0,0,0,0,0,0,0,0,0,0,0,0,0,0,0,627,0,0,0,0,0,0,0,0,627,0,0,0,0,0,0,0,0],
			[0,0,0,0,0,0,0,0,0,0,0,626,0,0,0,0,0,0,0,628,0,625,0,0,0,0,0,0,0,0,0,0,0,0,0,0,0,0,0,0],
			[0,625,0,0,0,0,0,0,0,0,0,0,0,0,0,0,0,0,0,0,0,0,0,0,0,0,0,0,0,0,0,0,0,0,309,0,0,0,0,0],
			[0,627,0,0,0,0,0,0,0,0,0,0,0,309,0,0,0,0,0,0,0,0,0,0,0,0,0,0,0,0,0,0,0,0,0,0,0,0,0,0],
			[0,0,0,0,0,0,0,0,0,0,0,0,0,0,0,0,0,0,0,0,0,0,0,0,0,0,0,0,0,0,0,0,0,0,0,0,0,0,0,0],
			[0,0,0,0,0,0,0,0,0,0,0,0,0,0,0,0,0,0,0,0,0,0,0,0,0,0,0,0,0,0,0,0,0,0,0,0,0,0,0,0],
			[0,626,0,0,0,0,0,0,0,0,0,0,0,0,0,0,0,0,0,0,0,0,0,0,0,0,0,0,0,0,0,0,0,0,0,0,0,0,0,0],
			[0,628,0,0,0,0,0,0,0,0,625,627,628,626,627,0,0,0,0,0,0,0,0,0,0,0,0,0,0,0,0,0,0,0,0,0,0,0,0,0],
			[0,0,0,0,0,0,0,0,0,0,0,0,0,0,0,0,0,627,0,0,626,0,0,627,0,0,625,0,0,626,0,0,0,0,0,0,0,0,0,0],
			[0,0,0,0,0,0,0,0,0,0,0,0,0,0,0,0,0,0,0,0,0,0,0,0,0,0,0,0,0,0,0,0,0,0,0,0,0,0,0,0],
			[0,0,0,0,0,0,0,0,0,0,0,0,0,0,0,0,0,0,0,0,0,0,0,0,0,0,0,0,0,0,0,0,0,0,0,0,0,0,0,0]
		]
	]
}
