{
	"player" : [ 3, 3 ],
	"width"  : 40,
	"height" : 24,
	"data" : [
		[
			[357,361,358,361,358,361,358,357,360,357,358,358,358,358,358,361,361,361,361,358,358,359,361,361,361,361,361,361,358,358,361,358,358,357,358,361,358,358,359,361],
			[357,361,358,359,358,361,358,357,359,357,358,358,358,358,358,361,361,361,361,358,358,358,358,359,358,358,360,359,360,357,358,359,358,358,361,359,361,361,361,361],
			[357,361,358,361,358,361,358,360,361,361,358,358,358,358,358,361,361,361,361,358,360,360,360,358,357,358,358,358,359,358,361,358,361,358,358,358,358,359,358,361],
			[357,361,358,361,358,361,358,360,361,361,358,358,358,358,358,361,361,361,361,358,358,358,357,357,357,357,358,358,361,361,361,361,361,361,361,361,361,361,361,361],
			[249,251,241,249,241,241,249,251,249,250,249,241,250,249,249,250,249,249,249,250,249,249,251,249,251,248,249,250,249,249,250,249,241,248,250,251,249,241,249,250],
			[0,0,0,0,0,0,0,0,0,0,0,0,0,0,0,0,0,0,0,0,0,0,0,0,0,0,0,0,0,0,0,0,0,0,0,0,21,0,0,0],
			[0,26,25,26,25,26,25,26,25,26,25,26,25,26,25,26,25,26,25,26,25,26,25,26,25,26,25,26,25,26,477,478,25,26,25,26,25,26,25,0],
			[0,22,21,22,21,22,21,22,21,22,21,22,21,22,21,22,21,22,21,22,21,22,21,22,21,22,21,22,21,22,21,22,21,22,21,22,21,22,21,0],
			[0,26,25,26,25,26,25,26,25,26,25,26,25,26,25,26,25,26,25,26,25,26,25,26,25,26,25,26,25,26,25,26,25,26,25,26,25,26,25,0],
			[0,22,21,22,21,22,21,22,21,22,21,22,21,22,21,22,21,22,21,22,21,22,21,22,21,22,21,22,21,22,21,22,21,22,21,22,21,22,459,0],
			[0,26,25,25,25,26,25,26,477,478,25,26,25,26,25,26,25,26,25,26,25,26,25,26,25,26,25,26,25,26,25,26,25,26,25,26,25,26,25,0],
			[0,22,21,22,21,22,21,22,21,22,21,22,21,22,21,22,21,22,21,22,22,22,21,22,21,22,21,22,21,22,21,22,21,22,21,22,21,22,21,0],
			[0,26,25,26,25,26,25,26,25,26,25,26,25,26,25,26,25,26,25,26,25,26,25,26,25,26,25,26,25,26,25,26,25,26,25,26,25,26,25,0],
			[0,22,21,22,21,22,21,22,21,22,21,22,21,22,21,22,21,22,21,22,21,22,21,22,21,22,21,22,21,22,21,22,21,22,21,22,21,22,21,0],
			[0,26,25,26,25,26,25,26,25,26,25,26,25,26,25,26,25,26,25,26,25,26,25,26,25,26,25,26,25,26,25,26,25,26,25,26,25,26,25,0],
			[0,22,21,22,21,22,21,22,21,22,21,22,21,22,21,22,21,22,21,22,21,22,21,22,21,22,21,22,21,22,21,22,21,22,21,22,21,22,21,0],
			[0,26,25,26,25,26,25,26,25,26,25,26,25,26,25,26,25,26,25,26,25,26,25,26,25,26,25,26,25,26,25,26,25,26,25,26,25,26,25,0],
			[0,22,21,22,21,22,21,22,21,22,21,22,21,22,21,22,21,22,21,22,21,22,21,22,21,22,21,22,21,22,21,22,21,22,21,22,21,22,21,0],
			[0,26,25,26,25,26,25,26,25,26,25,26,25,26,25,26,25,26,25,26,25,26,25,26,25,26,25,26,25,26,25,26,25,26,25,26,25,26,25,0],
			[0,22,21,22,21,22,21,22,21,22,21,22,21,22,21,22,21,22,21,22,21,22,21,22,21,22,21,22,21,22,21,22,21,22,21,22,21,22,21,0],
			[0,26,25,26,25,26,25,26,25,26,25,26,25,26,25,26,25,26,469,470,471,26,25,26,25,26,25,26,25,26,25,26,25,26,25,26,25,26,25,0],
			[0,22,21,22,21,22,21,22,21,22,21,22,21,22,21,22,21,22,21,22,21,22,21,22,21,22,21,22,21,22,21,22,21,22,21,22,21,22,21,0],
			[0,26,25,26,25,26,25,26,25,26,25,26,25,26,25,26,25,26,25,26,25,26,25,26,25,26,25,26,25,26,25,26,25,26,25,26,25,26,25,0],
			[0,22,21,22,21,22,21,26,21,22,21,22,21,22,21,22,21,22,21,22,21,22,21,22,21,22,21,22,21,22,21,22,21,22,21,22,21,22,21,0]
		],
		[
			[0,0,0,0,0,0,0,0,0,0,0,0,0,0,0,0,0,0,0,0,0,0,0,0,0,0,0,0,0,0,0,0,0,0,0,0,0,0,0,0],
			[0,0,0,0,0,0,0,0,0,0,0,0,0,0,0,0,0,0,0,0,0,0,0,0,0,0,0,0,0,0,0,0,0,0,0,0,0,0,0,0],
			[0,0,0,0,0,0,0,0,0,0,0,0,0,0,0,0,0,0,0,0,0,0,0,0,0,0,0,0,0,0,0,0,0,0,0,0,0,0,0,0],
			[0,0,0,0,0,0,0,0,0,0,0,0,0,0,0,0,0,0,0,0,0,0,0,0,0,0,0,0,0,738,739,0,0,0,0,0,0,0,0,0],
			[0,0,0,0,0,0,0,0,0,0,0,0,0,0,0,0,0,0,0,0,0,0,0,0,0,0,0,0,741,742,743,744,0,0,0,0,0,0,0,0],
			[0,0,0,0,0,0,0,0,0,0,0,0,0,0,0,0,0,0,0,0,0,0,0,0,0,0,0,0,0,0,0,0,0,0,0,0,0,0,0,0],
			[0,0,0,0,0,0,0,0,0,667,0,0,0,0,0,667,0,0,0,0,0,0,0,0,0,666,0,0,0,0,0,0,0,0,0,0,0,0,0,0],
			[0,0,0,0,0,13,0,0,0,0,0,0,0,0,0,0,0,0,0,0,13,0,0,0,0,0,0,0,0,0,0,0,0,0,0,0,0,0,0,0],
			[0,666,0,0,0,0,0,0,0,0,0,0,0,0,0,0,0,0,0,0,0,0,0,0,0,0,0,0,0,0,0,0,0,0,0,0,0,0,0,0],
			[0,0,0,0,0,0,0,0,0,0,0,0,0,0,0,0,0,0,13,0,0,0,0,0,0,0,0,0,0,0,0,0,584,0,0,0,13,0,0,0],
			[0,576,0,0,0,0,0,0,0,0,0,0,0,0,0,0,0,0,0,0,0,0,0,666,0,0,0,0,0,0,0,0,0,0,0,0,0,0,0,0],
			[0,584,0,0,0,0,0,0,0,0,0,666,0,0,0,0,0,0,0,0,0,0,0,0,0,0,0,0,0,0,0,0,0,0,0,0,0,0,0,0],
			[0,576,576,0,13,0,13,0,0,0,0,0,0,0,0,0,0,0,0,0,0,576,0,0,0,0,0,0,0,584,0,0,0,0,0,0,13,0,0,0],
			[0,0,0,0,0,0,0,0,0,0,0,0,0,0,0,0,0,0,0,0,0,0,0,0,0,0,0,0,576,576,584,0,0,0,0,0,0,0,0,0],
			[0,0,0,0,0,667,0,0,0,667,0,0,0,0,0,667,0,0,0,0,0,0,0,0,0,0,0,0,0,0,0,0,0,0,0,0,0,0,0,0],
			[0,13,0,0,0,0,0,0,0,0,0,0,0,13,0,0,0,0,0,0,0,13,0,0,0,0,0,0,0,0,0,0,0,0,0,0,0,0,0,0],
			[0,0,0,0,0,0,0,0,0,0,0,0,0,0,0,0,0,0,0,0,0,0,0,0,0,0,0,13,0,0,0,0,0,0,0,0,0,0,0,0],
			[0,0,0,0,0,667,0,0,0,667,0,0,0,0,0,0,0,0,0,0,0,0,0,0,667,0,0,0,0,0,0,0,0,0,0,0,0,0,0,0],
			[0,13,0,0,0,0,0,0,0,0,0,0,0,13,13,13,0,576,0,0,0,0,0,0,0,0,0,0,0,0,0,0,0,0,0,0,13,0,0,0],
			[0,0,0,0,0,0,0,0,0,0,0,0,0,0,0,0,0,0,0,0,0,0,0,0,0,0,0,0,0,0,0,0,0,0,0,0,0,0,0,0],
			[0,0,0,0,0,0,0,0,0,0,0,0,0,0,0,0,0,0,0,0,0,0,0,0,0,0,0,0,0,0,0,0,0,0,0,0,0,0,0,0],
			[0,13,0,0,0,0,0,0,0,0,0,0,0,0,0,0,0,0,0,0,0,666,0,0,0,0,0,0,0,666,0,0,0,0,0,0,666,0,0,0],
			[0,0,0,0,0,0,0,0,0,0,0,0,0,0,0,0,0,0,0,0,0,0,0,0,0,0,0,0,0,0,0,0,0,0,0,0,0,0,0,0],
			[0,0,0,0,0,0,0,0,0,0,0,0,0,0,0,0,0,0,0,0,0,0,0,0,0,0,0,0,0,0,0,0,0,0,0,0,0,0,0,0]
		],
		[
			[0,0,0,0,0,0,0,0,0,0,0,0,0,0,0,0,0,0,0,0,0,0,0,0,0,0,0,0,0,0,0,0,0,0,0,0,0,0,0,0],
			[0,0,0,0,0,0,0,0,0,0,0,0,0,0,0,0,0,0,0,0,0,0,0,0,0,0,0,0,0,0,0,0,0,0,0,0,0,0,0,0],
			[0,0,0,0,0,0,0,0,0,0,0,0,0,0,0,0,0,0,0,0,0,0,0,0,0,0,0,0,0,0,0,0,0,0,0,0,0,0,0,0],
			[0,0,0,0,0,0,0,0,0,0,0,0,0,0,0,0,0,0,0,0,0,0,0,0,0,0,0,0,0,0,0,0,0,0,0,0,0,0,0,0],
			[0,0,0,0,0,0,0,0,0,0,0,0,0,0,0,0,0,0,0,0,0,0,0,0,0,0,0,0,0,0,0,0,0,0,0,0,0,0,0,0],
			[1096,1095,1096,1095,1096,0,0,1095,1096,1095,1096,1095,1096,1095,1096,1095,1096,1095,1096,1093,1096,1095,1096,1093,1096,1094,1096,1095,1096,1095,1093,1096,1093,1094,1096,1095,0,1095,1094,1095],
			[1095,0,0,0,0,0,0,0,0,0,0,0,0,0,0,0,0,0,0,0,0,0,0,0,0,0,0,0,0,0,0,0,0,0,0,0,0,0,0,1094],
			[1096,0,0,0,0,0,0,0,0,0,0,0,0,0,0,0,0,0,0,0,0,0,0,0,0,0,0,0,0,0,0,0,0,621,621,621,621,621,0,1096],
			[1094,0,0,0,621,621,621,0,0,0,0,0,621,621,621,621,621,621,621,621,621,621,621,621,621,621,621,621,621,0,0,0,0,0,0,0,0,609,0,1095],
			[1093,0,0,0,0,609,0,0,0,0,0,0,0,0,0,0,0,0,0,0,0,0,0,0,0,0,0,0,0,0,0,0,0,0,0,0,0,609,0,1095],
			[1094,0,0,0,621,621,621,0,0,0,0,0,0,0,0,0,0,621,621,621,621,0,0,0,0,0,0,0,0,0,0,621,621,621,621,621,621,621,0,1094],
			[1095,0,0,0,0,609,0,0,0,0,0,0,0,0,0,0,0,0,0,0,0,0,0,0,0,0,0,0,0,0,0,0,0,0,0,0,0,609,0,1096],
			[1096,0,0,0,0,609,0,0,0,0,0,0,0,0,0,0,0,0,0,0,0,0,0,0,0,0,0,0,0,0,0,0,0,0,0,0,0,609,0,1095],
			[1095,621,621,621,621,621,621,621,621,621,621,621,621,621,621,621,621,621,621,621,621,621,621,0,0,0,0,0,0,0,0,0,0,0,0,0,621,621,0,1093],
			[1093,0,0,0,0,0,0,0,0,0,0,0,0,0,609,0,0,0,0,0,0,0,0,0,0,0,621,621,621,621,621,621,621,621,621,621,621,621,0,1095],
			[1095,0,0,0,0,0,0,0,0,0,0,0,0,0,609,0,0,0,0,0,0,0,0,0,0,0,609,0,0,0,0,0,0,0,0,0,0,0,0,1096],
			[1093,621,621,621,621,621,0,0,0,621,621,621,621,621,621,621,0,0,621,621,621,621,621,621,621,621,621,0,0,0,0,0,0,0,0,0,0,0,0,1093],
			[1095,0,0,0,0,0,0,0,0,0,0,0,0,0,609,0,0,0,0,0,0,0,0,0,0,0,621,621,621,621,621,621,621,621,621,621,621,621,0,1095],
			[1094,0,0,0,0,0,0,0,0,0,0,0,0,0,609,0,0,0,0,0,0,0,0,0,0,0,0,0,0,0,0,0,0,0,0,0,0,609,0,1093],
			[1096,621,621,621,621,621,0,0,0,621,621,621,621,621,621,621,621,621,621,621,621,621,621,621,621,621,621,621,621,621,621,621,621,621,621,621,621,621,0,1095],
			[1095,0,0,0,0,0,0,0,0,0,0,0,0,0,0,0,0,0,0,0,0,0,0,0,0,0,0,0,0,0,0,0,0,0,0,0,0,0,0,1094],
			[1093,0,0,0,0,0,0,0,0,0,0,0,0,0,0,0,0,0,0,0,0,0,0,0,0,0,0,0,0,0,0,0,0,0,0,0,0,0,0,1094],
			[1095,1093,0,0,0,0,0,0,0,0,0,0,0,0,0,0,0,0,0,0,0,0,0,0,0,0,0,0,0,0,0,0,0,0,0,0,0,0,0,1095],
			[1096,1093,1094,1093,1095,1096,1096,1093,1094,1095,1094,1093,1095,1094,1096,1094,1096,1094,1095,1094,1096,1093,1094,1096,1095,1094,1096,1093,1095,1096,1094,1096,1095,1093,1096,1094,1093,1096,1095,1096]
		],
		[
			[0,0,0,0,0,0,0,0,0,0,0,0,0,0,0,0,0,0,0,0,0,0,0,0,0,0,0,0,0,0,0,0,0,0,0,0,0,0,0,0],
			[0,0,0,0,0,0,0,0,0,0,0,0,0,0,0,0,0,0,0,0,0,0,0,0,0,0,0,0,0,0,0,0,0,0,0,0,0,0,0,0],
			[0,0,0,0,0,0,0,0,0,0,0,0,0,0,0,0,0,0,0,0,0,0,0,0,0,0,0,0,0,0,0,0,0,0,0,0,0,0,0,0],
			[0,0,0,0,0,0,0,0,0,0,0,0,0,0,0,0,0,0,0,0,0,0,0,0,0,0,0,0,0,0,0,0,0,0,0,0,0,0,0,0],
			[0,0,0,0,0,0,0,0,0,252,253,0,0,0,0,0,0,0,0,0,0,0,0,0,0,0,0,0,0,0,0,0,0,0,0,0,0,0,0,0],
			[0,0,0,0,0,0,0,0,0,0,0,0,0,0,0,0,0,0,0,0,0,0,0,0,0,0,0,0,0,0,0,0,0,0,0,0,0,0,0,0],
			[0,0,0,0,0,0,0,0,0,0,0,0,0,0,0,0,0,0,0,0,0,0,0,0,0,0,0,0,0,0,0,0,0,0,0,0,0,0,0,0],
			[0,0,0,0,0,0,0,0,0,0,0,0,0,0,0,0,0,0,0,0,0,0,0,0,0,0,0,0,0,0,0,0,0,0,0,0,0,0,0,0],
			[0,0,0,0,0,0,0,0,0,0,0,0,0,0,0,0,0,0,0,0,0,0,0,0,0,0,0,0,0,0,0,0,0,0,887,888,0,0,0,0],
			[0,0,0,0,0,0,0,0,0,0,0,0,0,887,888,0,0,0,0,0,0,0,0,0,0,0,0,0,0,0,0,0,0,0,891,892,0,0,0,0],
			[0,0,0,0,0,0,0,0,0,0,0,0,0,891,892,0,0,0,0,0,0,0,0,0,0,0,0,0,0,0,0,0,0,0,0,0,0,0,0,0],
			[0,0,0,0,0,0,0,0,0,0,0,0,0,891,892,0,0,0,887,888,0,0,0,0,0,0,0,0,0,0,0,0,0,0,887,888,0,0,0,0],
			[0,0,0,0,0,0,0,0,0,0,0,0,0,891,892,0,0,0,891,892,0,0,0,0,0,0,0,0,0,0,0,0,0,0,891,892,0,0,0,0],
			[0,0,0,0,0,0,0,0,0,0,0,0,0,0,0,0,0,0,0,0,0,0,0,0,0,0,0,0,0,0,0,0,0,0,891,892,0,0,0,0],
			[0,0,0,887,888,0,0,0,0,0,887,888,0,0,0,0,0,0,0,0,0,0,0,0,0,0,0,0,0,0,0,0,0,0,0,0,0,0,0,0],
			[0,0,0,891,892,0,0,0,0,0,891,892,0,0,0,0,0,0,0,0,0,0,0,0,0,0,0,0,0,0,887,888,0,0,887,888,0,0,0,0],
			[0,0,0,0,0,0,0,0,0,0,0,0,0,0,0,0,0,0,0,0,0,0,0,0,0,0,0,0,0,0,891,892,0,0,891,892,0,0,0,0],
			[0,0,0,887,888,0,0,0,0,0,887,888,0,0,0,0,0,0,0,0,0,887,888,0,0,0,0,0,0,0,0,0,0,0,0,0,0,0,0,0],
			[0,0,0,891,892,0,0,0,0,0,891,892,0,0,0,0,0,0,0,0,0,891,892,0,0,0,0,0,0,0,0,0,0,0,0,0,0,0,0,0],
			[0,0,0,0,0,0,0,0,0,0,0,0,0,0,0,0,0,0,0,0,0,0,0,0,0,0,0,0,0,0,0,0,0,0,0,0,0,0,0,0],
			[0,0,0,887,888,0,0,0,0,0,0,0,0,0,0,0,0,0,0,0,0,0,0,0,0,887,888,0,0,0,0,0,0,887,888,0,0,0,0,0],
			[0,0,0,891,892,0,0,0,0,0,0,0,0,0,0,0,0,0,0,0,0,0,0,0,0,891,892,0,0,0,0,0,0,891,892,0,0,0,0,0],
			[0,0,0,891,892,0,0,0,0,0,0,0,0,0,0,0,0,0,0,0,0,0,0,0,0,891,892,0,0,0,0,0,0,891,892,0,0,0,0,0],
			[0,0,0,0,0,0,0,0,0,0,0,0,0,0,0,0,0,0,0,0,0,0,0,0,0,0,0,0,0,0,0,0,0,0,0,0,0,0,0,0]
		]
	]
}
