{
	"player_start" : [ 3, 2 ],
	"level_width"  : 40,
	"level_height" : 24,
	"level_data" :
		[
			[356,356,356,356,356,356,356,356,356,356,356,356,356,356,356,356,356,356,356,356,356,356,356,356,356,356,356,356,356,356,356,356,356,356,356,356,356,356,356,356],
			[356,356,356,356,356,356,356,356,356,356,356,356,356,356,356,356,356,356,356,356,356,356,356,356,356,356,356,356,356,356,356,356,356,356,356,356,356,356,356,356],
			[356,356,356,356,356,356,356,356,356,356,356,356,356,356,356,356,356,356,356,356,356,356,356,356,356,356,356,356,356,356,356,356,356,356,356,356,356,356,356,356],
			[356,356,356,356,356,356,356,356,356,356,356,356,356,356,356,356,356,356,356,356,356,356,356,356,356,356,356,356,737,738,356,356,356,356,356,356,356,356,356,356],
			[248,248,248,248,240,248,248,240,248,248,248,248,248,248,248,248,248,248,240,240,248,248,248,248,248,248,248,740,741,742,743,248,248,248,248,248,248,248,248,248],
			[1095,1094,1095,1094,1095,1094,1095,1094,1095,1094,1095,1094,1095,1094,1095,1094,1095,1094,1095,1094,1095,1094,1095,1094,1095,1094,1095,1094,1095,1094,1095,1094,1095,1094,1095,1094,21,1094,1095,1094],
			[1094,20,21,20,21,20,21,20,21,20,21,20,21,20,21,20,21,20,21,20,21,20,21,20,21,20,21,20,476,477,21,20,21,20,21,20,21,20,21,1095],
			[1095,24,25,24,25,12,25,24,25,24,25,24,25,24,25,24,25,24,25,24,12,25,24,25,24,25,24,25,24,25,24,25,24,620,620,620,620,620,25,1094],
			[1094,20,21,20,620,620,620,20,21,20,21,20,620,620,620,620,620,620,620,620,620,620,620,620,620,620,620,620,620,20,21,20,21,20,21,20,21,608,20,1095],
			[1095,24,25,24,25,608,24,25,24,25,24,25,24,25,24,25,24,25,12,24,25,24,25,24,25,24,25,24,25,24,25,24,575,25,24,25,12,608,458,1094],
			[1094,575,21,20,620,620,620,21,476,477,20,21,20,21,20,21,20,620,620,620,620,21,20,21,20,21,20,21,20,21,620,620,620,620,620,620,620,620,20,1095],
			[1095,583,24,25,24,608,24,25,24,25,24,25,24,25,24,25,24,25,24,25,24,25,24,25,24,25,24,25,24,25,24,25,24,25,24,25,24,608,21,1094],
			[1094,575,575,25,12,608,12,20,21,20,21,20,21,20,21,20,21,20,21,20,21,575,20,21,20,21,20,21,20,21,575,20,21,20,21,20,21,608,20,1095],
			[1094,620,620,620,620,620,620,620,620,620,620,620,620,620,620,620,620,620,620,620,620,620,620,24,25,24,25,24,25,575,575,583,24,25,24,25,620,620,21,1095],
			[1095,20,21,20,21,20,21,20,21,20,21,20,21,20,608,21,20,21,20,21,20,21,20,21,20,21,620,620,620,620,620,620,620,620,620,620,620,620,20,1094],
			[1094,12,25,20,21,20,21,20,21,20,21,20,21,12,608,20,21,20,21,20,21,12,20,21,20,21,608,20,21,20,21,20,21,20,21,20,21,20,21,1095],
			[1095,620,620,620,620,620,24,25,24,620,620,620,620,620,620,620,20,21,620,620,620,620,620,620,620,620,608,12,20,21,20,21,20,21,20,21,20,21,20,1094],
			[1094,20,21,20,21,20,21,20,21,20,21,20,21,20,608,21,20,21,20,21,20,21,20,21,20,21,620,620,620,620,620,620,620,620,620,620,620,620,21,1095],
			[1095,12,25,24,25,24,25,24,25,24,25,24,25,12,608,12,24,575,25,24,25,24,25,24,25,24,25,24,25,24,25,24,25,24,25,24,12,608,25,1094],
			[1094,620,620,620,620,620,21,20,21,620,620,620,620,620,620,620,620,620,620,620,620,620,620,620,620,620,620,620,620,620,620,620,620,620,620,620,620,620,21,1095],
			[1095,20,21,20,21,20,21,20,21,20,21,20,21,20,21,468,469,470,21,20,21,20,21,20,21,20,21,20,21,20,21,20,21,20,21,20,21,20,21,1094],
			[1094,12,25,20,21,20,21,20,21,20,21,20,21,20,21,20,21,20,21,20,21,20,21,20,21,20,21,20,21,20,21,20,21,20,21,20,21,20,21,1095],
			[1095,1094,24,25,24,25,24,25,24,25,24,25,24,25,24,25,24,25,24,25,24,25,24,25,24,25,24,25,24,25,24,25,24,25,24,25,24,25,24,1094],
			[1094,1095,1094,1095,1094,1095,1094,1095,1094,1095,1094,1095,1094,1095,1094,1095,1094,1095,1094,1095,1094,1095,1094,1095,1094,1095,1094,1095,1094,1095,1094,1095,1094,1095,1094,1095,1094,1095,1094,1095]
		]
}
